#################
#               #
#   x           #
#               #
#               #
#      ssss     #
#               #
#               #
#               #
#               #
#################
